IBM	IBM
微软	微软
德勤	德勤
京东金融	京东
京东	京东
腾讯	腾讯
阿里巴巴	阿里
蚂蚁金服	阿里
支付宝	阿里
达摩院	阿里
蚂蚁	阿里
百度	百度
华为	华为
毕马威	毕马威
埃森哲	埃森哲
火币	火币
汇丰银行	汇丰
汇丰	汇丰
马士基 马士基
苏宁	苏宁
家乐福 家乐福
浙商	浙商银行
迅雷	迅雷
招商银行	招商银行
中国移动 移动
移动	移动
纳斯达克	纳斯达克
甲骨文	甲骨文
Facebook	Facebook
亚马逊	亚马逊
AWS 亚马逊
万向 万向区块链
微众	微众
趣链 趣链
平安	平安
兴业银行	兴业银行
建设银行	建设银行
中国人民银行 中国人民银行
人民银行 中国人民银行
央行 中国人民银行
科技 其他科技公司
国网 国家电网
国家电网 国家电网
